0000000000
0000000000
0000010000
0000010000
00000*011E
0000011100
0000000000
0000000000
0000000000
0000000000