000000000
000000000
000001000
000001000
00000*01E
000001110
000000000
000000000

